15 13
48 48
2 3 3 3 3 3 3 3 3 3 3 3 3 3 2
2 0 0 4 4 0 4 4 4 4 0 0 0 0 2
2 0 3 0 3 4 3 0 3 4 3 4 3 0 2
2 0 0 4 0 0 4 4 4 0 4 4 4 0 2
2 0 3 4 3 4 3 0 3 4 3 4 3 4 2
2 4 4 4 0 0 4 4 4 4 4 4 4 4 2
2 4 3 4 3 4 3 4 3 4 3 0 3 4 2
2 4 4 4 4 4 0 4 4 0 4 4 4 0 2
2 4 3 4 3 4 3 4 3 4 3 0 3 4 2
2 0 4 4 0 4 4 4 4 4 0 4 0 0 2
2 0 3 4 3 0 3 4 3 0 3 4 3 0 2
2 0 0 0 4 4 4 4 4 4 4 0 0 0 2
2 3 3 3 3 3 3 3 3 3 3 3 3 3 2
